10.ox
.o..oo.oo.
..o.ooo...
oo.o.o..o.
.oo.oooooo
..o....o.o
o.oo.oo...
ooo..o.oo.
..ooooo.oo
.o.....o.o
..o..oo.o.
