10.ox
..o...o...
..o..o....
..oo....o.
......o..o
o.o....ooo
...o..oo..
.oo.oo.o..
.........
....oo....
oo..o.....
